############
#   X    O #
#       ####
#          #
# X        #
#    ##  P #
#    ##    #
#   O      #
#       XX #
#       #  #
############
