############
#        O #
#       ####
#          #
#          #
#    ##  P #
#    ##    #
#   O      #
#       XX #
#   P   #  #
############
